NO sprites/eagle.xpm
SO sprites/brick.xpm
WE sprites/erdog.xpm
EA sprites/anime.xpm
F 166,166,166
C 51,198,227
111111111
1000000011111111
10001000000000001111
100E0000000000000001
10000000000000001111
1000000011111111
111111111
