NO sprites/bluestone.xpm
SO sprites/brick.xpm
WE sprites/mossy.xpm
EA sprites/wood.xpm
F 184,113,39
C 51,198,227
111111111111111111111111111111
10000000001100000000000000000011
10110000011100000000000010000001
1011000000000000000000001000111
00110000011100000000000010001
10000000001100000111011110001
11110111111111011100000010001
11110111111111011100000010001
1111110011N101011101010010001
10000000000000001100100010001
10000000000000001101010010001
11000000110101000000000000001
11110111111101000000000000001
100000000011111111000001000111111111
10000000001       1000011100111111111
10000000001       11010101001111111111
10000000001       11100000001111111111
10000000011       110100000011111111111
11111111111      11111101111111111111111