NO sprites/bluestone.xpm
SO sprites/brick.xpm
WE sprites/mossy.xpm
EA sprites/wood.xpm
F 184,113,39
C 51,198,227
111111111
110000001
 1 11S0011
111100111
1110001
1111111