NO sprites/bluestone.xpm
SO sprites/brick.xpm
WE sprites/mossy.xpm
EA sprites/wood.xpm
F 184,113,39
C 51,198,227
111111111111111111111111111111
100000010000000000010000000001
1000000111010101010100000000001
100000000000000000000011111101
110000S00000000000000010000001
101000000001000000100010000001
110000000100100000100010000001
100000111000010000010010000001
111111111111111111111111111111