NO sprites/bluestone.xpm
SO sprites/erdog.xpm
WE sprites/mossy.xpm
EA sprites/wood.xpm
F 184,113,39
C 51,198,227
111111111111111111111111111111
1N0000000000000000000000000001
111111111111111111111111111111