NO sprites/bluestone.xpm
SO sprites/erdog.xpm
WE sprites/mossy.xpm
EA sprites/wood.xpm
F 184,113,39
C 51,198,227
1111111111
1000001111
1E00011111
1111001111
1000001111
1111111111